{
    "tileset": "path.png",
    "field": [
		[2, 2, 2, 2, 2, 2, 9, 10, 11, 2, 2, 2, 2, 2, 2],
		[2, 2, 2, 2, 2, 2, 9, 10, 11, 2, 2, 2, 2, 2, 2],
		[2, 2, 2, 2, 2, 2, 9, 10, 11, 2, 2, 2, 2, 2, 2],
		[2, 2, 2, 2, 2, 2, 9, 10, 11, 2, 2, 2, 2, 2, 2],
		[2, 2, 2, 2, 2, 2, 9, 10, 11, 2, 2, 2, 2, 2, 2],
		[2, 2, 2, 2, 2, 2, 9, 10, 11, 2, 2, 2, 2, 2, 2],
		[6, 6, 6, 6, 6, 6, 10, 10, 10, 6, 6, 6, 6, 6, 6],
		[10, 10, 10, 10, 10, 10, 10, 1, 10, 10, 10, 10, 10, 10, 10],
		[14, 14, 14, 14, 14, 14, 10, 10, 10, 14, 14, 14, 14, 14, 14],
		[2, 2, 2, 2, 2, 2, 9, 10, 11, 2, 2, 2, 2, 2, 2],
		[2, 2, 2, 2, 2, 2, 9, 10, 11, 2, 2, 2, 2, 2, 2],
        [2, 2, 2, 2, 2, 2, 9, 10, 11, 2, 2, 2, 2, 2, 2],
		[2, 2, 2, 2, 2, 2, 9, 10, 11, 2, 2, 2, 2, 2, 2],
		[2, 2, 2, 2, 2, 2, 9, 10, 11, 2, 2, 2, 2, 2, 2],
		[2, 2, 2, 2, 2, 2, 9, 10, 11, 2, 2, 2, 2, 2, 2]
	]
}
